syntax - წერის წესების
() - ბრჩხილები
'' - ბრჭყალები
variable - ცვლადი
variable name - ცვლადის სახელი
variable value - ცვლადის მნიშვნელობისგან


Paragraph - ტექტსი
header - სათაური

Level 04:
assign - მინიჭება
parenthesis - ბრჩხილები
quotation marks - ბრჭყალები

Level 05:
image - სურათი
source - წყარო
uppercase - დიდი სიმბოლები
lowercase - პატრა სიმბოლოები

Level 07:
bold - მუქი
underline - ქვედახაზი
anchor - ღუზა

Level 09:
order - დალაგებული, წყობა
unorder - დაულაგებელი
contain - შეიცავს
bullet point - წერტილოვანი პუნტქი
attribute - მახასიათებელი

Level 10:
decimal - ათწიალდი
explicit - ხელოვნური
implicit - ბუნებრივი
comparsion - შედარება

# Level 12
not - უარყოფა
and - და
or - ან
sequence - მიმდევრობა
loop - მარყუჟი, ციკლი
range - დიაპაზონი, წვდომის არეალი

level 13:
submit - დადასტურება
label - ეტიკეტი
require - საჭიროება
while - სანამ
infinite - უსასრულო

level 15:

level 17::
responsive - მორგებადი
article - სტატია
section - სექცია
aside - განზე
color - ფერი
background-color - ფონის ფერი
font-size - შრიფტის ზომა
font-weight - ტექსტის სისქე
text-align - ტექსტის განლაგება
border - საზღვარი

level 18:
if - თუ
else - სხვა შემთხვევაში
condition - პირობა
break - შეწყვეტა
continue - გაგრძელება

level 19
property - კუთვნილება
divide - დაყოფა